16 16
WWWWWWWWWWWWWWWW
W           ~  W
W      ~~~~~~  W
W    W      W  W
W    W      WWWW
W              W
W              W
W              W
W              W
W              W
W              W
W              W
W              W
W              W
W              W
W              W
WWWWWWWWWWWWWWWW
